00000000000000000000000000000000
01010000100011110000000010100000
01110000100011110000000010100000
10100000100011110000000010100000
11110000100011110000000010100000
00010000100011110000000010100000
00100000100011110000000010100000
01100000100011110000000010100000